1111111111111111111111111111111111111111111111111111111111111111
1111111111111000000000000000000011111111111111111111111111111111
1111111111111001010000000001010011111110000000000011100000111111
111111111111100101000000000101001111111001000001001110CCC0111111
1111111111111001010000E0000101000000000000000000000000CCC0111111
111111111111100101000000000101001111111001000001001110CCC0111111
1111111111111000000000000000000011111110000000000011100000111111
1111111111111111111111111001111111111111111111111111111111111111
1CCCCCCC11111111111111111001111111111111111111111111111111111111
1CCCCCCC11111111111111111001111111111111111111111111111111111111
1CCCCCCC11110000001111111001111111111111111111111111111111111111
1111011111110CCCC01111111001111111111111111111111111111111111111
1111011111110CCCC01111111001111110000000000000011111111111111111
11110111111100000011111110011111100100CCCC0010011111111111111111
11000001111111001111111110000000000000CCCC0000011111111111111111
11000001111111001111111110011111100100CCCC0010011111111111111111
1100000000000000000000000001111110000000000000011111111111111111
1100000111110111111111111111111111111111111101111111111111111111
1100000111110111111111111111111111111111111101111111111111111111
1111111111110111111111111111111111111111111101111111111111111111
1111111111110111111111111111111111111111111101111111111111111111
1111111111110111111111111111111111111111111101111111111111111111
1111111111110111111111111111111111111111111101111111111111111111
1111111111110111111111111111111111111111111101111111111111111111
1111111111110111111111111111111111111111000000000111111111111111
1111110000000000000000000111111111111111001000100111111111111111
1111110001001000001001000111111111111111000000000111111111111111
1111110000CC0000000CC00001111111111P0000000000000111111111111111
1111110001001000001001000111111111111111000000000111111111111111
1111110000000000000000000111111111111111001000100111111111111111
1111111111111111011111111111111111111111000000000111111111111111
1111111111111111011111111111111111111111111111111111111111111111
1111111111111111011111111111111111111111111111111111111111111111
1111111111111111011111111111111111111111111111111111111111111111
1111111111111100000111111111111111111111111111111111111111111111
1111111111111100000111111111111111111111111111111111111111111111
1111111111110000C00001111111111111111111111111111111111111111111
111111111111000C0C0001111111111111111111111111111111111111111111
11111111110000C0C0C000011111111111111111111111111111111111111111
1111111111000C0C0C0C00011111111111111111111111111111111111111111
1111111111111111111111111111111111111111111111111111111111111111
1111111111111111111111111111111111111111111111111111111111111111
1111111111111111111111111111111111111111111111111111111111111111
