11111111
1P0000C1
11101111
10000EC1
11111111
