111111111111111111111111111111111111111111111
1000000000000000000000000000000000000000000E1
1001000010000000000000000000000000000000000C1
1001000010000000000000000000000000000000000C1
1001000010000000000000000000000000000000000C1
1001000010000000000000000000000000000000000C1
1001000010000000000000000000000000000000000C1
1001000010000000000000000000000000000000000C1
1001000010000000000000000000000000000000000C1
1001000010000000000000000000000000000000000C1
1001000010000000000000000000000000000000000C1
1001000010000000000000000000000000000000000C1
1001000010000000000000000000000000000000000C1
1001000010000000000000000000000000000000000C1
1001000010000000000000000000000000000000000C1
1001000010000000000000000000000000000000000C1
1001000010000000000000000000000000000000000C1
1001000010000000000000000000000000000000000C1
1001000010000000000000000000000000000000000C1
1001000010000000000000000000000000000000000C1
1001000010000000000000000000000000000000000C1
1001000010000000000000000000000000000000000C1
1001000010000000000000000000000000000000000C1
1001000010000000000000000000000000000000000C1
1001000010000000000000000000000000000000000C1
1001000010000000000000000000000000000000000C1
1001000010000000000000000000000000000000000C1
1001000010000000000000000000000000000000000C1
1001000010000000000000000000000000000000000C1
1P0000000000000000000000000000000000000000001
111111111111111111111111111111111111111111111
