1111111111111111111111111111111111111111111111111111111111111111
1111111111111000000000000000C00011111111111111111111111111111111
1111111111111001010000000001010011111110000000000011111111111111
1111111111111001010000000001010011111110010000010011111111111111
11111111111110010100000000010100000000000000E0000011111111111111
1111111111111001010000000001010011111110010000010011111111111111
1111111111111000000000000000000011111110000000000011111111111111
1111111111111111111111111001111111111111111111111111111111111111
1000000011111111111111111001111111111111111111111111111111111111
1000000C11111111111111111001111111111111111111111111111111111111
1000000011111111111111111001111111111111111111111111111111111111
1110101111111111111111111001111111111111111111111111111111111111
1110101111110000001111111001111110000000000000011111111111111111
1000000011110000001111111001111110000111111000011111111111111111
10000000111100000C1111111000000000000000000000011111111111111111
1000000011110000001111111001111110000111111000011111111111111111
1000000000000000000000000001111110000000000000011111111111111111
1000000011110111111111111111111111111111111101111111111111111111
1000000011110111111111111111111111111111111101111111111111111111
1111111111110111111111111111111111111111111101111111111111111111
1111111111110111111111111111111111111111111101111111111111111111
1111111111110111111111111111111111111111111101111111111111111111
1111111111110111111111111111111111111111111101111111111111111111
1111111111110111111111111111111111111111111101111111111111111111
1111111111110111111111111111111111111111000000000111111111111111
1111110000000000000000000111111111111111001000100111111111111111
1111110001001001001001000111111111111111000000000111111111111111
11111100000000000000000001111111111P00000000C0000111111111111111
1111110001001001001001000111111111111111000000000111111111111111
1111110000000000000000000111111111111111001000100111111111111111
1111111111111111011111111111111111111111000000000111111111111111
1111111111111111011111111111111111111111111111111111111111111111
1111111111111111011111111111111111111111111111111111111111111111
1111111111111111011111111111111111111111111111111111111111111111
1111111111111100000111111111111111111111111111111111111111111111
1111111111111100000111111111111111111111111111111111111111111111
1111111111110000000001111111111111111111111111111111111111111111
1111111111110000000001111111111111111111111111111111111111111111
1111111111000000000000011111111111111111111111111111111111111111
1111111111000000000000011111111111111111111111111111111111111111
1111111111111111111111111111111111111111111111111111111111111111
1111111111111111111111111111111111111111111111111111111111111111
1111111111111111111111111111111111111111111111111111111111111111
