111111111111111
10C10000000E0C1
100001111101111
1P0011E00000111
111111111111111
