1111111111111111111111
10000000000000000000E1
10000000000000000000P1
1C00000000000000000001
1111111111111111111111
