111111111111111111111111111111
10000000000C000000000000110001
100001111100111111111110110101
101101111100111111111110110101
101101111100111111111110110101
101101111100111110000000000101
101101111100111110000000110101
101101111100000000000000110101
101101111101111101001000110101
1P0001E0000000000C000000110001
111111111111111111111111111111
