111111111111111111111111111111
10000000000C000000000000110001
100001111100110110010000110101
101101111100110110010000110101
101101111100110110010000110101
101101111100110110000000000101
101101111100110110000000110101
101101111100000000000000110101
101101111101111000000000110101
1P0001E00000000000000000110001
111111111111111111111111111111
